en - Hello
ar - السلام عليكم
cs - Dobrý den
da - God dag
de - Guten Tag
el - Γειά σου
es - Buenos días
eo - Bonan tagon
eu - Kaixo
fi - Hyvää päivää
fr - Bonjour
he - שלום
hi - नमस्ते
hr - Dobar dan
hu - Jó napot
it - Buongiorno
ja - こんにちは
ka - გამარჯობა
ko - 안녕하세요
lv - Labdien
nl - Goededag
no - God dag
pl - Dzień dobry
pt - Bom dia
ro - Bună ziua
ru - Здравствуйте
sv - God dag
tr - İyi günler
vi - Chào anh
zh - 你好
